1111111111111
1P0CCCC0000E1
1111111111111
