1111111111111
1P0CCCCCCCCE1
1111111111111