1111111111111
1PE0CC0000001
1111111111111
