11111111111111
10000P0000CC01
11110000C00001
1010E000000111
11111111111111
