1111111111
10DP0CC111
1100EC1111
1100000011
1011111D11
100D00D011
1111111111