111111111
100P0CC11
1100EC111
111111111
