1111111119
10DP0CC111
1100EC1111
1000000011
1011111D11
100D000011
1111111111