111111111
10DP0CC11
1100EC111
100000001
1011111D1
100D00001
111111111
